21 21
#####################
# #     #   #     # #
# # ##### # # ### # #
# #     # # # #   # #
# ##### # # # # # # #
# #   # # # # # # # #
# # # # # # # # # # #
# # # # # # # # # # #
# # # # # # # # # # #
# # # # # # # # # # #
# # # # ### # # # # #
# # # #   # # # # # #
# # ### # # # # # # #
# #     # # # # # # #
# ####### # # # # # #
# #       # # # # # #
# ######### # # # # #
# #         # # # # #
# ########### # # # #
#             #  &  #
#####################