100 100
####################################################################################################
################################ # ###                                                             #
#                                     # #  ##### ### #################### #    #                 # #
# #                                              #                                   #  ## ####### #
#                                                #                                               # #
#     #  #                                       #                                               # #
#     #                        ###############    #   ##### ########                             # #
#     #                                      #    #   #                     #  ##############    # #
#     #                                      #   #    #                                     #    # #
##    #                                      #   #    #                                     #    # #
##    #   ###############################             #                                     #    # #
##    #   #                                  #   #    #   #       #######################   #    # #
##    #   #                                  #   #    #   #                             #   #    # #
##    #   #                                  #   #    #   #                             #   #    # #
##    #   #   ##########################     #   #    #   #                             #   #    # #
##    #   #                                 ##   #        #   ######################    #   #    # #
##    #   #                                      #        #                        #    #   #    # #
##    #   #                                      #        #                        #        #    # #
##    #   #   #                                  #        #                             #   #    # #
##    #   #   #    #      ########################        ##########               #    #   #    # #
##    #   #   #    #                             #                  ###### #####   #    #   #    # #
##    #   #   #    #                             #                             #   #    #   #    # #
##    #   #   #    #                             #                             #   ##   #   #    # #
##    #   #   #    #   #######################   #    ####                          #   #   #    # #
#     #   #   #    #   #                     #   #             #############   #    #   #   #    # #
#     #   #   #    #   #                     #   #                         #   #    #   #   #    # #
##    #   #   #    #   #                     #   #                         #        #   #        # #
##        #   #    #   #        #            #   #                         #   #    #   #        # #
##   #    #   #   ##   #                #    #   #        ##############   #   #    #   #        # #
##   #    #   #    #   #                     #   #        #            #   #   #    #   #        # #
##   #    #   #        #                     #   #        #            #   #   #    #   #   #    # #
##   #    #   #   #    #                     #   #        #            #   #            #        # #
##   #        #        #        ##############   #   #    #            #   #            #        # #
##   #        #        #   #    #                #   #    #    ####    #   #   #    #   #        # #
##   #        #        #        #                #   #    #       #        #   #        #        # #
##   #    #   #   #    #   #    #                #   #    #       #    #   #        #   #        # #
##   #    #   #        #   #    #   ######### ####   #    #       #    #   #   #    #   #        # #
##   #        #        #   #    #   #                     #####   #    #   #   #    #   #   #    # #
#    #        #   #    #   #    #   #                #        #   #    #   #   #    #   #   #    # #
##   #        #        #   #    #   #                         #        #   #   #    #   #        # #
##        #   #   #    #   #        #                #        #        #   #   #    #   #        # #
##        #       #    #   #    #   #   ###################   #        #   #            #        # #
##        #       #    #   #        #   #                 #   #   #        #        #            # #
##   #    #       #    #   #        #   #    # #          #   #   #        #        #            # #
##   #    #       #    #   #        #   #                 #   #            #   #    #            # #
##   #    # #  ####    #   ##########   #                 #   #                     #            # #
##   #                 #                #    # ###        #   #          ###        ## #####     # #
##   #                 #                #    ##    #  #   #   #                #                 # #
##   #                 #                #     #       #   #   #                #                 # #
##   #####################################    #    # #    #   #                                  # #
##                                      #   ####   # #    #   #################################### #
##                                      ##   # ## ## #    #                                      # #
##                                               #..#     #                                      # #
################### ######   #   # ##    #      #...# #   #                                      # #
##                 #    #  ##### ####      #     ### #    #################################      # #
##                ##                #          ##    ##   #                #                 #   # #
##                ##                #   #      ####  #    #                #                     # #
##   ##########    #                #   #                 #                #                 #   # #
##   #        #   #    ##########   #   ######   ##########   ##########   #                 #   # #
##   #        #   #    #        #   #        #   #            #        #   #            #    #   # #
##   #        #   ##   #       ##   #        #   #            #        #   #    #       #        # #
##   #        #    #   #       #    #        #   #            #        #   #            #    #   # #
##   #    #   #   #    #   #   ##   #####    #   #    ##### # #        #   #                 #   # #
##   #    #   #   #    #   #    #            #   #    #   #  ##   ##   #   #        #   #    #   # #
##   #    #   #   ##   #   #    #            #   #    #           ##   #   #        #   #    #   # #
##   ##   #   #   #    #   #   ##           ##   #    #           ##   #   #        #   #    #   # #
##   #    #   #        #   #   #########    ##   #    #           #    #   #        #   #    #   # #
##   #    #   #        #   #              ####   #    #   #########    #   #        #        #   # #
##   #    #   #   ##   #   #                     #    #   #            #   #        #   #    #   # #
##   #    #   #    #   #   #                     #    #   #            #   #        #   #    #   # #
##   #    #   #   ##   #   #                     #    #   #            #   #        #        #   # #
##   #    #   #   #    #   #######################    #   #   ##########   #   #    #   #    #   # #
##   ##   #   #    #   #                         #    #   #                #   #    #   #    #   # #
##   ##   #   #    #   #                         #    #   #                #   #    #   #    #   # #
##   #    #   #    #   #                         #    #   #                #   #    #   #    #   # #
##   #    #   #        #######################   #    #   ## ### # ###   # #        #   #    #   # #
##   #    #   #    #                         #   #    #                             #   #    #   # #
##   #    #   #    #                         #   #    #                             #   #    #   # #
##        #   #    #                         #   #    #                             #   #    #   # #
##   #    #   #    ######################    #   #    #######    ###                #   #    #   # #
##   ##   #   #                                  #        ######################    #   #    #   # #
##   ##   #   #                              #   #   #                              #   #    #   # #
##   #    #   #                                  #                                  #   #    #   # #
##   #    #   ######### #  ##########   # ##     #                                  #   #    #   # #
##   #    #                                      #        ###########################   #    #   # #
##   #    #                                      #   #    #                             #    #   # #
##        #                                      #   #    #                             #    #   # #
##    #####                                      #   #    #                             #    #   # #
##   #######      ################################   #    #   ######################### #    #   # #
##  ###....##                                    #   #    #      #                           #   # #
##  ##.###.##                                    #   ##   #                                  #   # #
##  ####.####                                    #   #    #                                      # #
##  ######.################################      #   #    #                                  #   # #
##   #######                                     #   #    ############################ #######   # #
##    #####                                      #   #                                           # #
#                                                #   #                                           # #
##  # ## # ### ### ###   ##   #   # #            #   #                                           # #
#                              ### # ## ##########   ############################################# #
#                                             #### & ####                                          #
####################################################################################################